█████████████████████████████
█           █               █
█  $        █               1
█           ████████        █
█       █                   █
█       █           B       █
█   H   █                   █
█████████████████████████████