██████████████████████
1         █          █
█   $     █     H    █
█         █          █
█      ███████       █
█                    █
██████████████████████