██████████████████████
2         █          █
█   $     █     H    █
█         █          █
█      ███████       █
█                    █
██████████████████████