██████████████████████
1         █          █
█   $     █     H    █
█  X       █         █
█      ███████    x  █
█   X                █
██████████████████████